....S.#.....
#...#.#.#.#.
#...#...#.#.
............
#...#.....#.
#.#...#.##..
....#.#....E
........#...
.....##..#..
.#..........